1111111111111
10000000000C1
1000011111101
1P0011E000001
10000000111C1
1111111111111