111111111111111111111111111111111111111111111111111111111111111111111111111111111111111111111111111111111111111111111111111111111
10000000000C111111111111111111111111111111111111111111111111111111111111111111111111111111111111111111111111111111111111111111111
100001111110111111111111111111111111111111111111111111111111111111111111111111111111111111111111111111111111111111111111111111111
1P0011E00000111111111111111111111111111111111111111111111111111111111111111111111111111111111111111111111111111111111111111111111
10000000111C111111111111111111111111111111111111111111111111111111111111111111111111111111111111111111111111111111111111111111111
