1111111111111
11111111111C1
1111111111101
1P0011E000001
10000000011C1
1111111111111